NO ./assets/normal_north.xpm
SO ./assets/normal_south.xpm
WE ./assets/normal_west.xpm
EA ./assets/normal_east.xpm

 F 0,100,100

    C    0,0,100

111111111111111111111
1E000000000000011111
1111111111111111111
1
1
