NO ./assets/normal_north.xpm
SO ./assets/normal_south.xpm
WE ./assets/normal_west.xpm
EA ./assets/normal_east.xpm

 F 1,100,0

    C    0,0,100



 1111111
1N1111011011
 11 111111

