NO ./assets/normal_north.xpm
SO ./assets/normal_south.xpm
WE ./assets/normal_west.xpm
EA ./assets/normal_east.xpm

 F 1,100,0

    C    0,0,100



111111111111111111111111111111111
1N10000000000001111111110000011111
1111111111111111111111111111111111111111111111111111
