NO ./assets/normal_north.xpm
SO ./assets/normal_south.xpm
WE ./assets/normal_west.xpm
EA ./assets/normal_east.xpm

F 220,100,0
C 225,30,0
 11
1001        1111111111111111111111111      11111111
 11      1000000000110000000000001
        1011000001110000000000001
        1001000000000000000000001
111111111011000001110000000000001
100000000011000001110111111111111

11110111111111011100000010001\n9999999999999999

99999999999999999999999999999999999999999999999

11110111111111011100000010001999999999999999999

11110111111111011101010010001
11000000110101011100000010001
10000000000000001100000010001
10000000000000001101010010001
1100000111010101111101111000111
11110111 111N101 111111111111
  11111111 1111111







