NO ./assets/lava_1_diffuseOriginal.xpm
SO ./assets/snow_bush.xpm
WE ./assets/lava_3_diffuseOriginal.xpm
EA ./assets/lava_2_diffuseOriginal.xpm

F 248,1,1
C 1,1,1

11111111111111111111111111111111111111111
10000000000000000000011000000000000000001
10000000000000010000000000000000000000001
10000000000000010000000000100000100000001
10000001000000000000000000000000100000001
10000000000001000000N00100001111110000001
10000001000000000000000000000000100000001
10000000000011000001100000000000000000001
10000001000000000000000000000000100000001
11111111111111111111111111111111111111111
