NO ./assets/normal_north.xpm
SO ./assets/normal_south.xpm
WE ./assets/normal_west.xpm
EA ./assets/normal_east.xpm

F 255,255,255
C 225,30,0

1111111111111111111111111111111111111111111111111111111
1000000000000000000000000001000000000010000000000000001
1011111111111110111111111101011111111110111111111111101
1010000000000000000000000001000000000000000000000000101
1010111111111110101111110111111111111111111111111110101
1E10100000000000100000000001000000000000000000000010101
1010101111111111111111111101011111111111111111111010101
1010101000000000100000000101010000000010000000000010101
1111111111111111111111111111111111111111111111111111111

