NO ./assets/OpenfootageNETVinesII_03.xpm
SO ./assets/OpenfootageNETVinesII_05.xpm
WE ./assets/OpenfootageNETVinesII_06.xpm
EA ./assets/OpenfootageNETVinesII_07.xpm

F 240,248,255
C 198,230,251

1111111111111111111111111111111111111111111111111111111
1000000000000000000000000001000000000010000000000000001
1011111111111110111111111101011111111110111111111111101
1010000000000000000000000001000000000000000000000000101
1010111111111110101111110111111111111111111111111110101
1010100000000000100000000001000000000000000000000010101
1010101111111111111111111101011111111111111111111010101
1010101000000000100000000101010000000010000000000010101
1010101011111110101111110101010111111010111111111010101
1010101010000010101000010101010000001010100000001010101
1010101010111010101011010101011111101010101111101010101
1010101010100010101000010101000000101010100000101010101
1010101011101110101011110101111110101010111110101010101
1010101000101000100000000100000000100010000010101010101
1010101111101010101111011111111111111011111010101010101
1000100000001010000000000000000000000000001000101010001
1011111111111010111110111011101110111110101111101011101
1000100000001010100000000000000000000010100000001000001
1E00111111101010100000000000000000000010101111111111111
1000100000001010000000000000000000000000100000000010001
1011101011111010100000000000000000000010101111111010101
1000101010001010100000000000000000000010101000000010101
1010101010101010111110111011101110111110101011111010101
1010101010101010000000000000000000000000101010001010101
1010101010101010111111111011111011111110101010101010101
1010101010101000000000000000000000000000001010101010101
1010101010101110101110111111101110111110111010101010101
1010101010100010101000001000100000100010000010101010101
1010101010111010101011101010111111101011111110101010101
1010101010001010101000101010000000001000000000101010101
1010101011101010101110101011111111111111111111101010101
1010101000001010100000101010000000000000000000001010101
1010101111111010111111101010111111111011111111111010101
1010100000000010000000001010100000001010000000000010101
1010111111111011111111111010101111111010111111111110101
1010000000000000000000001010100000000010000000000000101
1011111111111011111111101010111111111011111111111111101
1000000000000000000000000010000000000000000000000000001
1111111111111111111111111111111111111111111111111111111
